red: 0,A
blue: 1,B
green: 2,C
+++++++++++++++++++++++++++++++++++++
++++++++++++++++++++++++++          +
++++++++++++++++++++++++++    +++++ +
+0      A                     + bc+ +
+++++B+++++++++++++++++++++++++ +++ +
+aA1                         2+C    +
+++++++++++++++++++++++++++++++++++++