red: 0,A
cyan: 1,B
green: 2,C
pink: 3,D
blue: 4,5
+++++++++++++++++++++++++++++++++++++
+++++++ ++++++++++dD4               +
+++++++ ++a+++++++++++++++++   ++++ +
+0      A                    2+ bc+ +
+++++B+++++++++++++++++++++++++ +++ +
+aA1                        Aa+C3   +
+++++++++++++++++++++++++++++++++++++