+++++++++++++++++
+   +++   X++++++
++  X +X + ++++++
+X X X    X++++++
+ +X  ++ + xxx+++
+0  ++ X + + Cx++
++  X      xx++++
+ XX +X+x  x+++++
+   +   +X xCxxX+
+++++ X    ++++++
+++++++++X ++++++
+++++++++++++++++